##########################__
#&...........##.....&....###
#.####.#####.##.#####.##...#
#.####.#####.##.#####.##.#.#
#.####.#####.##.#####....#.#
#......................###.#
#.#..#.##.##...###.##.####.#
#.####.##.########.##.####.#
#......##....##....##......#
############_##_#####.######
#......#####_##_#####......#
#.####.##....&.....##.####.#
#......##_###_####_##......#
######.##_###_####_##.######
....##....###$####..........
######.##.### ####_##.######
######.##.########_##.######
#......##..........##......#
######.##_########_##.######
..####.##_########_##.####__
#...................&......#
#.####.#####.##.#####.####.#
#.####.#####.##.#####.####.#
#...##.......@........##...#
###.##.##.########.##.##.###
###.##.##.########.##.##.###
#......##....##....##......#
#.##########.##.##########.#
#.##########.##.##########.#
#..........................#
############################
############################